########################################
# C C C C C C C C C  C C C C C C C C C #
# C               C  C               C #
# C      *        C  C       *       C #
# C               C  C               C #
# C C C C C C C C C  C C C C C C C C C #
####  ##########       ###########  ####
#    E       E E E E E E          E    #
#     E                          E     #
#      E                        E      #
# E               #                  E #
#E                                    E#
# E          #    P    #             E #
#E                                    E#
# E               #                  E #
#                                      #
#                                      #
#          E E   E E E   E E E         #
#C                                    C#
########################################