



            ###############
            ## EE E EE E ##
            ## EE E EE E ##
            ## EE E EE E ##
            ## EE E EE E ##
            #             #
#############      C      ##############
#                                      #
#     C            P         C         #
#          C    #######          C     #
#                  *                   #
########################################






