########################################
#                                      #
#                                      #
#                                      #
#                E                     #
#                                      #
#                               E      #
#    E     ##################          #
#         #        E         #         #
#         #                  #         #
#   E     #        *         #   E     #
#         #                  #         #
#         #        P         #         #
#          ##################          #
#                                      #
#                                      #
#     E                        E       #
#                 E                    #
#                                      #
########################################