########################################
#                                      #
#                  C                   #
#                  E                   #
#                                      #
#                                      #
#                                      #
#                                      #
#                                      #
#                                      #
#                                      #
#                                      #
#                  P                   #
#                                      #
#                                      #
#                                      #
#                                      #
#                                      #
#                                      #
########################################