########################################
#                                      #
#                                      #
#                                      #
#                                      #
#                                      #
#                                      #
#                                      #
#                                      #
#              E  E E E E E            #
#                          E     #  C  #
#                   #     E   E  #  C  #
#  P               *#     E   E  #  C  #
#                   #     E   E  #  C  #
#                           E    #  C  #
#              E  E E E E E            #
#                                      #
#                                      #
#                                      #
########################################