########################################
#                            ###########
#   C                        ###########
#                            ###########
#   C             C            #########
#                                #######
####         ########              #####
####       ############C             ###
####     ################    *       ###
####     ################            ###
####       ############C           #####
####         ########            #######
#  E  E                         ########
#         E   E  C            ##########
#       E                    ###########
# E E E     E                ###########
#   E E E E E                ###########
# E E E E E E                ###########
#     E E E E      P         ###########
########################################